>Rosalind_6137
GCGCATACGACCGAAACAGTTCGTTAATCTTTATCAGTAAAACTTCTCCATGTGCGCATG
GCTAGGCTTTTCACATATAACAGTTTAATGCACAGAGCAAATCGATCTTTTAGGTTTGGG
GTTAGATATATACCGTAGGAAACCTGGGGCCAGCAGTGGAGCGCTGCTCAAGAGAATAAT
ATGCGTCAATGAACCCGGGTCAGGACCGTGCTCCGGGAAAGTATAAGCACACACACGTAA
CAACCCATGTGTCATACACATTGACGGACTAGGGGCGGATTACTGAGCGAGGGCAATGTA
ATCGGGCTGGAATCGGTCGATGCAACCTAGCTTATAACATGTGCACTCCCCTAACTTTCA
GTTACCTGGAGAACCTAATATCATCAATACGCCGCCTCAAGCTGCCCGGAATGAACACGC
GAATTTAAGGGTAAAGGATATGACAGCCACGGCCGTGGCCCGCTGGAGGTCCGAGAGCCC
GCAGGGTTCTCCTGTCCTCTGAGTACCAGCATGCATGAGGGGAGAGCCCTAAGTTAGCCG
GCGCTGTGTAAGCTTTATTAGAAAGCTCGGTACTACGCCCCTAAATTTAACGTTTCCAAG
ACAGAGGTCTAATGGTCCCCGGCGCGTGCTTCGCTCGACAGACTCTTGTTGCTGGTACTG
CTAATAGAACTTGCTGTCTCTGTTTACACTATGTTTTAAAGATCCATGTCCCTTCCAGCG
GGGTTCTCATAAACGCTACGAGTCTGCGCAAACCTAGAGAACATATGATGCTACCCATTC
AAAGACAGCTTATGAGTTAGGAAGGTGGACATAAATGTCCCTGCACTTGTCCTTAATGAA
GGTACGCAAAGCATATTAGAAGACGGCCCGTTAGCTGGCACGCCTTCCGACCCTTTCCAG
ATAT
