>Rosalind_2306
TATCGCTAACTCTAGATTGTGAAGGTGGATTACACTCTTTCTCTACGTACCTTTCAAGGG
GGCTGCACACTCGAAAAATATCCTTAGGCTCACAACTGAGCGAGCAGTCGAGTATGTGAC
ACATAAAGCAACTTCAATGGTGTCTGCGAGATTAGGGAGCGACACTACGTCACTTATTGG
TAAGTTAAGAGAAATAGTGGACGATCATCCCCAACGCTTCCCGTGGGTGAACGCACTCGT
TACATGATGGTGCAGTGTGTTGGATCCATCAATGTGTGGCTACTGGTGCGCTTTTTTAGG
GCTGATACATGGTTACCGCATTAATGGCGGCAACGAAGGAGATGTTAAGACCCGGGTTTC
AAAAGCGTCAAAATATGAATAAACGAGATGTCTACACTGCCCTCCAACTGAACACGCATT
GGAGGGGCATGTGACCCGGCTAAGCATTCCCCTCATGACGTCGTAGTATTGTGATACGCA
GCCCGCTATTAATTCCTGGCTTAAGGGACGAGGTCCTGGAGGTGTCTAAACAGTAATACC
CTCCTGCGACCGAGTTAGTCCCCCTTGCTAAGTTTCTCGTAGTTAATGCTTTAGAAGAGC
TGTGGCAGACGATCCCCAATAGTAAGATGCCGAAAACGAGGGACAGCGAATCAGCAGGAA
TTTACGTCCGTAGGTCTCCCATTATGTGCTAGTTCAGAGGGCGTGCAGACTATGAGGGCT
GGCTGACGGGGTTCAGGGATCTTAGATTTAACCCATGCCTTATTAGGGGCCTGTTCCTGC
GTGGATAATTCCGAATTAACTGCAATCGTCGGTTAGGAGGACCACGAAATACTATACTCG
TCCCTGGCCGATCCATCACTGTCTGTACTTGGCATTATAATACATGATATTTACACCTCC
CTCAGGACCGATGACGTGACCCTTACTAGATC
>Rosalind_4615
ACATGCGATAGCGTTGAAGCTGCAATTCGTGGGAATTTAGCACATATTAGTCCCCATGCA
TTCACTAAATGATGATTAGCTACGGGAAAACTCTAAAACCGGGCTGCTTGCGATGACCAA
TGGTAACGAAAACCGAAGACACCGTCGCTGTTGAAAAGCTTTTGCCAAAACCTGGTGAGC
ACCACACTCGACAAAATATAGGTTACAGGGGCATCTACTCGCGGCGTAGCGTCCGTAGGC
AACAAATCGAGCGCATGCAAGCCGGTCCTTATAGCAATCCAAGAGTGAATGTTGCACCCC
TGTCTCCCGAAATCCTTCTGTAAAAAGGACTTCTAGACTTGGTTGTCTGGGTCTTGTTCA
TGCGCCCCATCAGGGAACGCCGGATCACGCCACCGATAGACACAGATTATTTCCAGCTCT
ACATAGGCGAGCTCTTCTCGCCATGGGTATAGGATCCATATTGAGCCCACCGCCAGCGGA
TTCTCTCTTTGAAAGGTAGAACTTGATGTCCAGTCCGGTTGAAGCTATCGTTGTTTCTCC
TCTAGCTCGTTAATTCAGATCAGCTCACAAGGGAGTGCTCGATATCCCGTAGCCTTCCAT
TGCCCTTAAAGTGACAGGTCCTAATTCAGGAAAGGCGAGTGCGTCATACGTTACGTCAGC
CCCAAGGCCCCAACGTTGATTAGCAGCTTTACTGACTGAGTTAGCAGCTGCACCAGCGCC
ACGGGAACCGGGCTTCTTTGCCAGTTTATAGGGCCCGTTGCTAGGCCCAATGTATGAGAT
GCTGGTAACCCGGATGAGTTACAGTCAACTCGTGTCGAATGGTGGATTTCTTGACTAAAC
TTGCCCCGTGGGGATGTAGGGTATTACAACCTCTGAAGGCTGTCCCAGTTAGAATATCTC
CTAGCTTTACATTACCCATAATTACCAAGTTT
>Rosalind_2954
TTCTTTGTGGCTCCAATCTTCTATCAGGCCACTATATTCAATGTACGACGCTAGCTACGT
TTCGCGTAGATTAAGTGAGCGAATGAGTTAGTCCGAACCATCCCAGATATACGTGCGCGA
CAAATACGCTTTATGGAGTAAAGGCGCAAGGGACGGCCATCGGTCTCCGAATTGGAGGTC
ATGACGGCCCGTACAGGCAGTATCACCAGGAGCTTTATGACGATATGTCGTTTATAGCAG
TGAGCTGTATAAATTCATAGCATGGCCCGGGCCTTTCGAGAAAAGATGCTTGCTCAACAC
GAAGATCTGCAGCTACACCCATCGATGCGCGGGAATATAAAACAAACTAGCGGGAGGGGC
CTTTGGCTATGAATCCCTGGGTATTATCTGACTACGCAGGTTGAGATCGATCGTACGCGC
TGATGGGTGCCAGGATTAGGTTACTAGGATCGGACAAGGACACGGGTATACGATAATCTA
CTACGCGATTCCATGAACGGGGGGGAACACATTAATCCCTCCTGATAACTACAACTACTC
GCTATTGCTTCCGGAGCGCAAAGCATCCAAACGTAAGTTCTAAGCCATGGGATGGATCGC
TTAATCTAACAAACGGTCTTACGCTGTAACGATGGCCGCAGTAGCAGGGAGGGAGGTAGT
CGTGGGGCGACGTTGCCCTGATTTATATGTGATATTGGTCGATTTCCGCTTCACAGCCTG
TGCGCGTCGGACCCAGAATTAAGGCGATCTAGCCTATTTACTGACTGGCGTTGTCCATGC
GGACCGAACGCCAGTGCCTTCTGCTCTTGTTCGCTAGAGTGCTTTTAACTGGTATAAATA
TCGCTCATCCAATCCAGGTTTATTCACGCTTTTACTTCTTCCCCCCCTGTCTCGCGCGCC
TTACCCCGGCGTTCACGCTTATCACAAATCGG
>Rosalind_0144
GCTAGTGGATAGATAAAGCATAGGGAACCCGCAAGTGCGCGGGAGGGCAACGATTCGTAA
CGCAATGTCGGCGACGGGGGTTCCCTTATACAGGACGTATTGTGGAGAGGTGCACCTTCA
GATGGTATCGATTTAAATAGCTAAGCCATGGTGCGTAACCCGTAATGACCGGTTACGAGT
CTACGGTAGAGATGGATAGTCAGCTGCTGGTACACCCAGGACTGACTATCAACAGCGAAG
CACCTGTCTACTTGCGACGCCTGCAGGAGAGCTATTCGTCTCAACGTCGTCGGTCCGCGC
CTTGCTGTGAGCTCTTTCGAAATGGGAGAGAGGAGGCCAGCCCACAGTGGGTATGGTTTG
TTGACCCAACCTTGGGTAACGTGTAGCTAGTAAGACGGGCATGCAGGGGCTTCCATCAGG
GGGCGGCAAGGCTAGCGACTGTTTCCCCCGCGAGTCGGTTTAGCGTTGGCTTAGCATCTC
TGCAGCCGGATGGATGCCGATAGTGTCTAGACTAAATCAACCTTTACCTCTGGTCTAACG
AATTTTACCGGGGGGATAATGGAACTATTGAATTATTCAAATTAATTTACCCTCCCGCGC
TTGCCGTCTAATCTTCGAAGAAACAGTGTCTGGCTTCTAGTATGACATTTTTAGGTCTAC
TACTCTCGTACTTCAGTACGACATGCTGTGGGGTAACGTCGAATTTTAAGCTGCGTGAGA
TGCTACCATAAGCAACGCAGAGTCGTTTTACCGGCGATAATTAACTTGTCGTTCAGACGA
CCACGATCCAGTACCAGGAATGGAGAACATGGTTCCCACGGCGTAGTAGTTGTGTCATAT
CGTTACGCGAGCTGTCGCAAACGCGCCAAGTCGTCTAAGCTAAGATATGACCTTTGTAAC
GGTTATTATCGCGTAGAAAATGCGCCCATAGA
>Rosalind_8520
GCGGCACGGTTCGGTAATCAAAATTCCCTGGTATTCCTGTCTTACCATACACAGTCGACT
CCCAGTCTTGCGTCATAATTTTACGTCGGGAGCTCACCACTGGCGAGATGCTTAAAAGAG
GTAGCACCATCGACGACCTATGTGGAGGAGCAGTATTTAATGCCCTGTGCCTCCGGATCG
TGTTACCCGGGAGGGGCGCCTGCTGTTACAAAGCGTCCTCGTGAGAAAGCACCCGAGCCA
TCCTATTTATTGAATCTTCCACCTTTCCCTGTTTCCTACGCACGCGGGCACCACGGACGG
ATCCGCCATATGTACGCGTGGGTACCGTTAATACCCAAAGGCGTCGTGGCCGATACAATC
TTTACATAGCGGTTCGGCATGCCACAAGTCTTCGAGCTCCATACGAGTAGTAGCTTTTGC
CCTCGGCCACTTATTTCGAGTTCCACATTGTGGATTTACCGCCGGGACGTACTGCAGTAA
GGGCTCGGTGCGCTGTGGGGGATGCTCCCTTCTTGCTCAGGGATCAGCTTTAACCGACAG
AGGACGCGATTGCTTTACTGGTTCTAGTCTGAATTATGACTCAACCCGAAAGGTATCCGC
CCTGAAGTGGCATATAAAGTCAGATGTTAATGTAGCCGGTTAATTGCCTATCCACCTCAC
CAATAAGTGGTGTCTTTTCATTAGGGTTTGCAGGGAAGGACGTCTCTGACTCTTAGTGGT
CAAGCCTTGTTGGGAGCTTCGAGCATAGAGCGTTTGGAGACTATAGCGTAATCCGCCAGG
ACACTCCCTAGCGGTCCTGTGAGTTGTGTTCGGCACGGCTCCTCGATCATCCTCCCTTAA
CGGCATCGCCTCTTCTCTCATTATCATCATCAGCTGCTTGCGAGTTGAGTCCTAAGCTTA
AGCCATATCTGTGATACCGCTCGACCGCTCAA
>Rosalind_9921
AGGGACTTTACGACTTTTATATGCTCCCGAGGGGGCGGAATCGATGAACTGTGGTCCCGA
TAAGCTGGGAGCACAGACTAAAGAAAACCTAGCCATAATTAGCCTGTTCCCTACCCTTCA
GCCCCGACCATCTAAGCACTTCCCAAGATACCTGTGATTGCGGGGACACCGTGATACAGG
TGGACCTTACTCGTTTAAGGGAGTGACGTACAATGATCGAGGATTGCAGCCTACTCTTAA
AGCGGAATATCCATTCATTGTCGTGAATGTTATTTCTTAGTGCCCCTCTAATCACTACCG
ACGCTCTGCCAGTAATGTTCGACTGGCCTGGAGCTGTCTGAACGATCCTTCTTCCGGGGA
AAGTATAAACAGATCTGTGAACGAGGCCTCGCGAAAAATGACAACCTGGTCTCCTTCAGT
GCCTGACCGCCGTCTACGGGAATCCGCGTGTGTCGGCAACCACCGGTACATATTCTGAAG
ACCAAATGCACTGATACAACGTCGTTGTTGTTTCTTCTGTCAGCAGCTGGTTTTTACAGC
GGCTTAATGTTAATCGAGTGGAAAATTACTGGACCCTCTTTTGAGACGGTCGTGACTTTT
CCGGGCGGGAGCGGTCGTCAGGGGGCACCGATAACCGCTCAGATGTGCTGCCGCGCGCGA
CAAGCCCCCCTAGACTGCCAATGAGTTGAACAATTCCCAAAAATGAGTTGCGAAACGGTA
GTGGGCCCGGTGCCGAGAACAATAAAAGCCACGCTGATTGACGTTCTGACCTATACTCGA
TAAGACGTACTACTAACCGAGCTCCGAACAAAAGTATTGGTTTAATGCCAGTTGGAAATC
AGATAGGACCTGAAGTTTTCCTTATGTCGGCGTTCCGGCTTCACGTGGGGCCACGGGCAT
TGCACCAAACACCAGACCATGCTGTGAGGTCT
>Rosalind_0568
GTTAGGCAGGCAGTAGTCATTAAGTCATGACCGTGATATTATTATGTAAATGGGCCATGA
ACCAGCTACGGGGGTGCGGGGTGAGCATTCGTCCTTGGCGTGGCCGCAGGATAAATAAAT
TCGAACAGAGCTACCAACTCTGTAGTAGGCGTACCTCGAAGCCGGTAATCACCATCTAGG
ACCCAGTGTTATAGCAGACCATACCGAAGTACAAAACTTTAACGTCAGTGCCAAACCAGA
GGGCACAGTTGGCTTTGAAGACGTCATACTGGGAGGCCGCAATAACTCGTTTACAGTCTG
TTAACGGACTACATGTCATCGATACTTTCCTTCACTCGTACTCACTGAAATTGAATACTA
CTACCAACAGCAAGGCACACACCGCGTCTAGAATAAGAATCAAGTTTTCCCGGCGCGTCA
CGTTTGAAACCGACAAACAACTTTTTCCCTCATGCTTGTCCTAACTCGCGTGACACTATA
TTCTGCCGCTCGCAACCCCTCCCTTAAATCGGTGTAGTTTTGCGCGGTAAACGACCGAAG
TCGGGCAGGAGCGCCCTTTCGCTTAACGATTCAAATGGGTCAAACCCCTGCAGTCTCCAC
TGAATAACGTCAGCCACATTCTTTAAGTTCTACACTCTATGTTCTGTCGCCTGAGCTGTG
CTGGCTTAAAGGCGCCACAGGCCTATGTCGACACAGTTCGTTTGCCCGGTGTTACTGGCA
CCTTGACATTTTGTAAGTTCAAATCGGCCCTCAACTCATATCGCAGTAAATGGCACCTAC
TGGCGCCGACCCTGCAGTCACCGTGCATTAGGATACGCAAAGACGGTGCCAATCGGTTAT
CCTCGGAGCGTACGTCGCTGAAGCTAACGGGACACAGGCTACATCACGGTACTCGCGTTG
AAGTACAGCCATGTGAAAGCCGATTTGCGAAT
>Rosalind_6646
ACCACTAATAACCTAATACGACGACGCGCGCCCAAAGAGAAGTAGTTACTGCTCCGCTAA
ATTGCTCCATAGTCGAGTTGAATGTTCATGCTCCATGGTGGCCTCTCTAGGTCGTTGGGT
GATTCAATTCTCTGCATGTTCGAAGGATGTCAGTTGACTAACCTTGTTACACCCAACAAT
CAGGTCCTGAACCGTCACGAAAACTGGGTCGTAGTTATACCTCCTGGCCGCGCACGCGGA
ATGGAAGCTTGTAAGTCGTGCACATACCTGGAAATAGTGCTTGCGACTAGGAGCAAAGCC
TAGGATCTTCGTGACACCTCTAAAACGAACTTAGTCTCGCAGGAGCTGCATGCTTGCAAC
AAACCTCGTTCACCTTTATCGGGTGCCAAGCAGCGTGGGGTGGTAAAGGTACTAGGTGTT
TGAGAACAGGTTTTGCTGAACTAGTCGCTCGAAGCCTGTCCGTTTTCCTATGGCGAAACC
GGCGCCACCCCGGAAGCGCTATTGCGACCGTCTAGTAGCCCTGAATTTGGGTCTTGGGAC
ATTTTGGATGATTGCAACTCACTAAAAGAGCCGAGGGGGTGCATGTGGTGAGAGGCTCGG
CTACCAACGCATCAGAGCAGTCTAGCCGTACGCCCCCTCTGGTCACAACGTATCAGAAAA
CTGCTGCGTTCGACCGACAACATACTAATGGGCCCGAACTTTTGTATGCCGGTTCCTTTG
GCCTCTCGCGGACGGTACTGCTGAAGGTTGTTGCTAATCGACTATCATGGAGTAGACTGC
GGCGGCGAAATCCAGTGATACACGGCTGAGAGAAAGCCGCTCCCCCTCGGTTACCTAGCC
CCTGCCGGATCAGCACAAACTCCCGACTGTTTCTGAGCGTAGTAAGTTAAATGTAAGTCC
CCCTTAACGGATGGTGCCGGCGAAGGTAAATG
>Rosalind_9491
CTCCAAAATCCTATCAGCATAAAGCTTCATTGGCCTATCTCCGGGTAACTTTCCGGTAAG
CGAATCGGGTTTCGGACATAGGTCACCGCACGGTGCTCAAATGTGTTACGGGATTCGGAT
AAACGTAATAGCCGATGATCACTCTCATGCACTGAGAGAGAGTCCACCCAGTAACTAGAG
CTATAGACCGATAACCGGTGGTTCCCAAAATACTTTCTAGTTTTGTCTACGATCGAAAAC
ACTACTGTGCAAGAATTATGTGGATGGGACTCTGCCGAGAGGCAGTCTCCCCGGAGCCGG
CTCGGCGACACCAGCCTTAATTGTTTGTGGTAGACACACTTGAACGGTCATCGCTTCTCT
CGACCACGGAGTACCCGTGTTATATGAGCATAGCCCTAGAAGCTATACGCAGCAACCCCT
AGTCGATATTTTAGAGGTGAATCTAGTGTGGCTTCCCGCCTAGGATAGACCTTTGCACGA
TACCGTATTCGAAGCGGGTGTCGGGTCAGCAGATTTCAACATGTGTTCCTTAGCCGCGAG
AGGAAGGGTGGTAGCTTATAGAATACAGAGTAATGAGATGACTTTCACAACGAGGTTCGC
ACGCGGTCATCTTCGACCCTGTAGGACCAAGTCTTCGAACGCCTTATCACTCATGTAATA
CCACTGGGCGGGTGCTGACCACTACGAAGTTCGTTAGTCGGGCTCAGCGGGGAAGTAACA
GAAACCAGCCCCGACTTGCCAGCTGGCCTAATTCCATAGCCAGCGCGTGTGGGGCCCCTG
ATTGGGTGAGTGCAAACGTATTACGTAGAGCTGATGACGCGAGAGCTAATACATCGATAC
TGGGTATCGGGCGTGCTACGCCATGGGTGGCTTATCACAATAGTCCAGACAACAACATTC
TTTCCTGGCTATTGATTCAATGGTTGTGGGTG
>Rosalind_0409
CAGTGATAGCGGTCTGACAAGTTAGCGTGCTACCCCCATCTATCAGTACGTGGCGTCTGG
GGTCACAGCGGACACTCGATACAAGCTGGGAGTTTTCTCGCTATCAGCATCTCTGTAGCA
TAGCCTCCCTTTTAAATAGAGTCGCAAACAACCGCCGTGGAGCCACTCGTGATGGAAACA
TACGCTAGCAGGATACTTGACAGCAGGAGAGCGCTCCTGCTGGCAATGTATTGCCTACGT
AAGCTGCAATGGAGCACGTACTCCGGTGTAATAAAGGAAGAGCTTACGTAGACTCGTGGG
ACAATTATATTCAACTCTATTGGGGGACGCATCATGAATCGCCACTATGCGGGGTCAGTT
TTCGGCCGTCCATGTGTGAAATCAGCTGCTAATGCTCTCGACGTATGATAGACGCCTAGG
TACTTTTTGCACCCCCAACTCTCTGTTGGTGTTGACGGGGCGTCGCTATGTATTACGCTG
CAGAACACACTCCAAGCGATAGTAGATCCTCAGGCGATATTGGCATTCTTCTAGTGGTTC
GACGTAAAGGACCGAACACGCTGTACCAGTTTCGGAGAAGTGGGGATTTAATTATTCTAT
CCCTTTACGTTTGAGCAACCGGAATAGATCAATTTCAGTGGTCTAGAAACGTTTGAGTGC
ACTATCATGCTGAAGAGAAAGCTGGTGTCACGAGCGTAGGTCCTACGGGTATTGACCCTT
TAACGTACAATCCGCCAGGCGATTTGAAGGTCAAAACGCAACGTCCCTACAATTACGTAG
AGTCTCATGAGTAGGGCTCCTAGTACCGGCTGATCACTTGTTTGCCGGGCAGCCTATCCA
TCCTCCTTATTAACAGCAACCCCGTTTCTATGTGACTAGACCCGGTGAGAGATACGCTTG
GTTTCCATAAGAGACTTGACAGGCACATGGAC
