>Rosalind_5842
CGCGCAGTACCGTGCCAGTAAGTTTCTCTCTACCATTAGGTACATGCTTATCTTGAACTT
TTTTTCTCTTTTTTCGATCCGCAAGCCCTTAGGGCGATGTGACACGCCTGCACCCTCGCA
CCCGGTAATCAGGGGCAGCATCCGATGACGCGTCGTACATATAATGGCTGCTGGAGTGGG
TTGTTTGTGATCCCCTGGATTAAGGCAGCTCAGGGATCATATTCGGAGAATGGAGAGTGG
TCGATCGACAGACGCCGTTCTTTGCTGAGGATCCATCAGATTCTCGGACGACCCAATCGC
GGCACACCCACATGGGCAGACTAGAGCGCTGACCTATGCAACAGACATGTAGAATAGAGT
GGGTGATCACACCCGCTAACCGCTAACCGAGTTGCAACGTCTGTCCCGATGGCCCTATTT
CTGCGTGTAGACCTGGCTAATAGCTAGTCCTAAATAGGTGGCCGAGAATCCAACACGCCT
AGGCGTGCAGGCGTTTTAAGTACTGACCTATCTCCAATACGGGCGGCGGGTTACCGATGG
AGCACCAGGCGGCTTAGGGGGTATATAACCCACCAACAAAGAACCTCTGATGCGCGTGGG
TTGTATACAAGTCAATGAGGTGAATTCTCTTCCCCTCGACCACCTTAACGAGATGCAACT
GCAATTAGTACTTGTTGGTACGTAACCCGGCTCATTTGTGGATGCGGCCAGTACTTAACT
CCTGGATTTGCCTACTCTCATACCGAGCCCTTAAGATGAGGAATCTAGTAAGTCAGCGGG
TTGGTCTAGACTCCGGACTAGGGGCAATGTCCGCGAGGCCGGGCGTCCCTTATCGTCAAT
AGGGCCATCAAAGCGCCCGTTTCTGCAATAAATTTCGAACGTACACACGAGTGCCCATTT
GACGAGGCATTAAACGCAGGTTAAGATGGTCCCCTAACACCTAGCCGGCCAAGCGATATA
