>Rosalind_3039
CGCGGTAAGAACGCCGCAGCCTATACGCCAGGGTGGAAGGGCCCTAGTTAGGTTACTGAG
CAATTTGGTCCGCTCCCACTCCACCTCCTGCACGTCGACGGACCTGGTGGACGTATCAGA
AAGCACAGACGACAGAACGACATGCGCGGTACTCAGACCGTATACGGTATGAATCTTTGA
GTTGCTCAGATTCTCAAGGAGGTCGCTTCGGTGCGGTGCTGGGCGCGGGATCCAACGTAA
AGACTGCCTACCCCGACCCTAGGGCAAATTGTTATGTTGCAGGGCTGGCCAGACTAACAC
CAGTCACCCATTAACTAGCACATTTTGTAGGTGCGGCATTTGTGCGCCCGAGGGTCGGGT
CGAGCTTGGACTACTAACGCATTCTGGGCTAGTACGCGCATCACTGCAAGCTTACTCTGA
TTTGTATGTGGAACGGGACCCTGCTGATTGTTGGGAGCCAAATGGGCCCATTCCAGAGCT
GAAGTGGCGCTAGCTCCAACAAAGCGAGAATTGAAGGAGCAGCGTGTAGACTTGCTACTC
CATGCCGGCTTCAGTTTATTCTTCCGAGTATCTTTAATATTACCGACACCGCGAATCAAA
GCTAGACCCCCGGTGTCTGAGGCTAGGTCGACCTCCGAGCGACCGGTTGATGTCCGCTCG
GATCCTCCAATTCACCCCTAACGTCCACCCATGCAGCCAGAGCATTTGATGACCCGGTGG
TTCCACAGGGCTGCGATTTAGGTATTAAATCGAGGCCGTTAATTCAGATCAACGTAACGG
TACATTCCAGGTTCGCTCGAGGTCTGGCACCGGGTTACGGTCCCTAAACATTCCTGCGGC
TCGCGCCAAAAGAGCGTGCAATATGGATTAATCTAAGAACGAGGTATTAGAGAGCGTAGA
ATGCCGTGCGTTAAAAGGTCGTGAAGGAGCGC
