>Rosalind_6738
ATATATGGTCCCTCCAAAGGGCCACTCAACGGAGTAGCGAGCAATCCCGTGTTTCTCCCA
ATGGGTACGTCCTGTGTCCGTCCCTGTTTAGTCGGGTTTACTGCTCTCCATCTGCTGGGG
GAGAACATTTGCTGGAGACTCTATGTGTAGTGTATAGCGGTTGGCCAGGTTGGATGCGGA
TACCGAGACACAGCTTGGAGTCTTTTACGCGTGGTTGAGATCTACGACAACAGTGTAATC
GGCATGAAAGGAGCGTTTATCTCTTACGACTACTAATAGGGGTGATTACCATTGCCTACT
CTGTAATGCTGTCCAGGGCCTTGACACTTGTGTGGAACCTCTACCACGAATTCTGCTAGC
GAGCGTGAGGCGCATCTGGTCCGGATCCAGCAAGGGTTTGCAGTAAACCCTTCTTCGCGG
CCAAGACTTGGATTGAGGTGTTTTGAGGCCAGAGGTACCATTAGGTACCGGTACCAAGGA
CACTGGTATGGCGCTTCATTATGCTTGTTCGGTAATTTAGAGATCGATCTTACATCATAC
ATAACTATGCGCTTTTAACCACAACATGCGAGGTCACTAGAGTTTGGCGAACATGGGTTA
AATCGCACTTCCCTTCCTACTCTATTAGCTGGCGTGCCAGCTCATGCATTCACGCTTGAT
AGCATTTATCTAGATACACCTAAGGTTTGCGTCATCGGATACAATCATATCTGGTATTGG
TTAGGCTCAAACTCCTTGCCTCTTTCACTACCCGGTCGTGGCCGTCTCTTCGCGGAGTGC
GACTAACAGCGTCTACATCGGATTGGGTTCTCTGGCAAGTAGTGGTATGATGTTTACTCG
AATATCCTGGCCCGGTACAGACTTGGTTGGCCTAGCTAATTAACGTACTGAAACGTCAAG
CACATGAATGGGTTGTATGAGCTTGCACTATGGTGCGC
